XXXXXXXXXXXXXXXXXXXX
X__________________X
X__________________X
X____XXXXX_________X
X________X_________X
X________X_________X
X________X_________X
X________X_________X
X________X_________X
X________X_________X
X________X_________X
X____XXXXX_________X
X__________________X
X__________________X
XXXXXXXXXXXXXXXXXXXX